w w w w w w w w w w w w w w w w w w w w
w b b b b b b b b b b b b b b b b b b w
w b g g g g g g g g g g g g g g g g g w 
w b g r g g g g g g g g g g g g g g g w 
w b g g g g g r g g g g g g g g g g g w 
w b g g g g g g g g g g g g r g g g g w 
w b g g g g g g g g g g g g g g g g g w 
w b g g g g g g g g g g g g g g g g r w 
w b g g g g g g g g g g g g g g g g g w 
w b g g g g g g r g g g g g g g g g g w 
w b g g g g g g g g g g g g g g g g g w 
w b g g g g g g g g g g g g g g g g g w 
w b g g g g g g g g g g g g g g g g g w
w b g g g g g g g g g g g g g g g g g w
w b g g g g g g g g g g r g g g g g g w
w b g g g g g g g g g g g g g g g g g w
w b g g g g g g g g g g g g g g g g g w
w b g g g g g g g g g g g g g g g g g w
w b b b b b b b b b b b b b b b b b b w
w w w w w w w w w w w w w w w w w w w w
